I   IIIIIIIIIIIIIIIIIIIIIIIIIIIIIIIIIIII
     III   IIIIIIIIIIIIIIIIIIIIIIIII III
            II   IIIIIIIIII IIIIIII   II
I                IIIIIIIII   IIIIII  III
I                II           IIII   III
II      II                     II    III
III    III                     II   IIII
IIII   III                          IIII
IIII   II        II                 IIII
II               II                  III
I                                    III
I                                   IIII
II                    II            IIII
IIII      II     II   II              II
IIIII     III    II                    I
IIIIII     II    II                    I
IIIIIII            II                  I
II IIII            II                 II
I   III                                I
I    III                               I
II   III    II      A  I               I
II          III       IIII   II        I
I            II       IIII   III        
I                             III       
I    II          II            I        
I    II    IIIIIIIII                    
I    I     IIIIIIII                     
I    I     IIIIIII                      
I   III                     II          
IIIIIIII            III     IIIIII      
IIIIIIII           IIII       IIII     I
IIIIIIII          IIIII                 
IIIIIII   II     IIII                   
IIII      II      II                    
IIII                                   I
III                                   II
II                                    II
II                                    II
III           I   I      II   I      III
IIIIII   IIIIIIIIIII    IIIIIIIII  IIIII
