IIIIIIIIIIIIIIIIIIIIIIIIIIIIIIIIIIIIIIII
IIIIIIIIIIIIII   II    IIIIIIIIIIIIIIIII
IIIIIIIIIIII         I IIIIIIIIIIIIIIIII
IIIIIIIIIIII       IIIIIIIIIIIIIII  IIII
IIII IIIIIIIII     IIIIIIIIIIIIII    III
III   IIIIIIII          IIIIIIIII    III
II     IIIIIIII          IIIIIII     III
II      IIIIIIIII        IIIIIII    IIII
II       IIIIIIII        IIIIII    IIIII
II       IIIIIII        IIIIII      IIII
II      IIIIIII        IIIIIII      IIII
III      III          III   II     IIIII
IIII                   I           II  I
IIII                          II   II  I
II       II                  III     III
II       II   II     II    IIIII     III
II            II    III    IIIII     III
III                IIIII   IIIIII    III
III   III          IIII        II   IIII
III  IIIII          II              IIII
II   IIII           A                 II
I   IIII   II             IIII         I
I   IIII   III            IIII         I
II  IIII    III          IIIIII        I
II   IIII    III       IIIIIIII        I
I     IIIII   III     IIIIIIIIII       I
I     IIIII   III     IIIIIIIIIII     II
     IIIIIII  II      IIIIIIIIIIIIIIIIII
     IIIIIIII      II  IIIIIIII  IIIIIII
I     IIIIIII     III   IIIIII    IIIIII
II        II      II       II     IIIIII
IIIII             II               IIIII
IIIIIIIII         III                 II
II IIIIII          I                   I
I    IIIII                            II
I     IIIII   II               II    III
I      III    III             IIII   III
I      III    IIII            IIIII IIII
II    IIIII  IIIIII  IIII    IIIIIIIIIII
III  IIIIIIIIIIIIIIIIIIIII  IIIIIIIIIIII
