IIIIII   IIII   IIIIIIIII  IIIIIIIIIIIII
IIII      II        IIII      IIII     I
IIII                 III      IIII      
IIIII        II     IIIII     IIII      
IIIIII       IIIIIIIIIIIIII    III     I
IIIIII        IIIIIII   IIII    III     
I                III     III     I      
I      I          I      III           I
II   IIII                III          II
I    IIIIIIIII            I           II
I        IIIII                         I
I           II  II                     I
I               II                     I
II              III    III              
III             III  IIIII              
IIII           IIII  IIII               
IIII         IIIIII   III              I
IIII   II   IIIIII     II             II
III   IIII  IIII       III           III
III  IIIII            IIII          IIII
III  IIIII          A III       II IIIII
IIIII                  I        III   II
IIIII                                  I
IIII        II                         I
IIII       IIII        II              I
I    II    III         II              I
     II                                I
     II                   II      I    I
I                         II     III  II
II                       III      IIIIII
IIII                     IIII      IIIII
IIII                     IIIIIII      II
II                           III       I
I                             I        I
I    I                                 I
I   III                          IIII II
I  IIIII             III         IIIIIII
IIIIIII       II    IIII          IIIIII
IIIIIII      III    IIIII         IIIIII
IIIIIIII  IIIIIII  IIIIIII  III   IIIIII
