IIII      IIIIIIIIIIIIIIIII IIIIIIIIIIII
III        IIIII    IIIIII    IIIIIIIIII
II         IIIII     IIIII     III    II
I          IIIII    IIIII      II     II
    III     IIII   IIIIII             II
    III      II  IIIIIIII            III
    III         II   IIIIIII         III
    III        II     IIIIII          II
    III        II      IIIII           I
   IIII       III         III          I
I  IIIII      IIII         II  II     II
I   IIII       IIII        II  II     II
I    III        IIII       II          I
II              III                    I
III   I              I           II    I
IIIIIIII            III         III    I
IIIIIII             IIII       IIII    I
IIII                 IIII     IIII    II
I                     III      III  IIII
                      III      III  IIII
                    A II       III     I
I  II                 II                
I  IIIII               II               
I    III               II               
II                    III    II        I
I                    IIII   III       II
I                  IIIII    II        II
                   II       II        II
                            II       III
                                     III
                  III     III III   IIII
                 IIIII    II IIIIIIIIIII
I                 IIII        IIIIIIIIII
III                             IIIIIIII
IIII                             IIIIIII
IIII                              IIIIII
III            II                  IIIII
III            II      III          IIII
IIII           III     IIII        IIIII
IIIIIII       IIIII   IIIIIII     IIIIII
