IIIIIIIIIIIIIIIIIIII
IA IOOO I       I  I
I  IOOO I       I  I
I  IOOO IIII  III  I
I   OOO            I
I  IIIII           I
I           OOOOOOOI
IIIIIIIIIIIIIIIIIIII