IIIIIIIIIIIIIIIIIIIIIIIIIIIIIIIIIIIIIIIIIII
IA IOOO I       I  I    OOOOOOOOOOOOOOOOOOI
I  IOOO I       I  I               OOOOOOOI
I  IOOO IIII  III  IIIIIIIIII      OOOOOOOI
I   OOO       OOO                  OOO    I
I  IIIII      OOO  I               OOO    I
I           OOOOOOOI                      I
IIIIIIIIIIIIIIIIIIIIIIIIIIIIIIIIIIIIIIIIIII